1111111111111111111111111111111111111111111111111
1P0CE00000000000000000000000000000000000000000001
1111111111111111111111111111111111111111111111111
