111111111111111111111111111111111111111111111111
1C000000000000000000000C0000000000000000000000C1
100000000000000000000000000000000000000000000001
100000000000000000000000000000000000000000000001
100000000000000000000000000000000000000000000001
100000000000000000000000000000000000000000000001
100000000000000000000000000000000000000000000001
100000000000000000000000000000000000000000000001
100000000000000000000000000000000000000000000001
10000000000000000000000000000EP00000000000000001
100000000000000000000000000000000000000000000001
1C00000000000000000000000000000000000000000000C1
100000000000000000000000000000000000000000000001
100000000000000000000000000000000000000000000001
100000000000000000000000000000000000000000000001
100000000000000000000000000000000000000000000001
100000000000000000000000000000000000000000000001
100000000000000000000000000000000000000000000001
100000000000000000000000000000000000000000000001
100000000000000000000000000000000000000000000001
100000000000000000000000000000000000000000000001
100000000000000000000000000000000000000000000001
1C00000000000000000000C00000000000000000000000C1
111111111111111111111111111111111111111111111111
