11111111111111111111111111111111111111111111111
1P000010000000100000001000001010000000100000001
10101110111010101011111010101011111010111111101
10100010100010101000100010101000100010000000001
10111010101110101110101110101110101110111011101
10001010101000000000101000101010100000001010001
11101010101111111110101011101010101111101010111
10101000101000001000101010000010101000101010001
10101111101011101111101010111010101011101011101
1010000010000010000000100000001010001000100C101
10111011101110111111111110111110101110111011101
10000010000010100000000010100000101000100000001
10111110111110101010111010101111111011101111111
10100010100000101010001010100000100010100000001
11101010101111101011101010111110101110111111101
10001000101000001000100010000010001000000000001
10111011101011111110101110101111111011111010111
10100010001000000000101000101000000000001010101
10101110111111111111101011111011111110101010101
10100010001000100000101000001000000010100010001
10111111101010101110101111101111111010111111101
100000000000100010000000001000000000100000000E1
11111111111111111111111111111111111111111111111