11111111111111111111111111111111111111111
1C00000000001000000P0000000000000010001C1
11111011111010111111111111111111101010101
10000010001000100000000000100010001010001
10111010101011101111111110101010111011101
10100010100010000000000010101000100000101
10111110111011101111111010101111111010111
10100000101000100000001010101000001010001
10101111101110111111101010101110101110101
10001000001000100010001010100000100010101
10111110101011101011101010111111111010101
10000010101000001000101010100000001010101
11111011101111111110111011101111101011101
10001000100000100010001000100000101000001
10111110111011101011101110111110101111101
10000000000010101000001000101000100000101
10111111111110101111111010101011101111101
10001000001000100010000010101010100000101
11111011101011111010111110101010111110101
10000010100010000010100010001000001010001
10111110111110111110101011111111101011111
10000010000000100010001010000000101010001
11111011111011111010111010101111101010101
10001000100010001010001000100000001000101
10101110101110101011101111111111111111101
1C100010100000101000100010000000100000001
11101110101111101010111010111111101011101
10001000100010001010001010100010001010001
10111011111110111010111010101010111010111
10000010000010101010000010101010100010001
10111110111010101011111110101010101111101
101000001000101010001000000010001000001C1
10111110101110101110101111101111111110111
10000000100000100010101000100010000010001
11111111111111101010111010111110111011101
10100010001000001010000010100010001000101
10101010101011101111111110101011101110101
10001010100010101000000010001010001010001
10111010111110101011101111111010111011101
100010000000001000001E0000000000100000001
11111111111111111111111111111111111111111
