111111111111111111111
1P0000000000000000001
101111111110111110101
101000000010000000101
101110111110101110101
100010000000100000101
111010111110111010111
100000100010000010001
101110111011111111101
100010000000100000101
111011111110111110101
10001000000C000010101
101011111111101010101
101000000010001000001
101110111010101111101
100010001010100000001
111011101010111111111
100000001010100000001
101110111010101110101
1000000010000000001E1
111111111111111111111